..............#XXXXXXXXXXXXXXXXXXXXX#.........................
.............#XXXXXXXXXXXXXXXXXXXXX#..........................
..............#XXXXXXXXXXXXXXXXXXXXX#.........................
.............#XXXXXXXXXXXXXXXXXXXXX#..........................
..............#XXXXXXXXXXXXXXXXXXXXX#.........................
.............#XXXXXXXXXXXXXXXXXXXXX#..........................
..............#XXXXXXXXXXXXXXXXXXXXX#.........................
.............#XXXXXXXXXXXXXXXXXXXXX#..........................
..............#######################.........................
..............................................................
..............................................................
..............#XXXXXXXXXXXXXXXXXXXXX#.........................
.............#XXXXXXXXXXXXXXXXXXXXX#..........................
..............#XXXXXXXXXXXXXXXXXXXXX#.........................
.............#XXXXXXXXXXXXXXXXXXXXX#..........................
..............#XXXXXXXXXXXXXXXXXXXXX#.........................
.............#XXXXXXXXXXXXXXXXXXXXX#..........................
..............#XXXXXXXXXXXXXXXXXXXXX#.........................
.............#XXXXXXXXXXXXXXXXXXXXX#..........................
..............#XXXXXXXXXXXXXXXXXXXXX#.........................
.............#XXXXXXXXXXXXXXXXXXXXX#..........................