XXXXXXXXXXXXXXXXXXXXXXXXXXXXXXXXXXXXXXXXXXXXXXXXXXXXXXXXXXXXXXXXXXXXXXXXXXXXXXXX
XXXXXXXXXXXXXXXXXXXXXXXX...................XXXXXXXXXXXXXXXXXXXXXXXXXXXXXXXXXXXXX
XXXXXXXXXXXXXXXXXXXX...............................XXXXXXXXXXXXXXXXXXXXXXXXXXXXX
XXXXXXXXXXXXX...............................................XXXXXXXXXXXXXXXXXXXX
XXXXXXXXXXX.......................................................XXXXXXXXXXXXXX
XXXXXXXXXXX......................................................XXXXXXXXXXXXXXX
XXXXXXXXX............................XXXXXXX.......................XXXXXXXXXXXXX
XXXXXXXXXX.......................XXXXXXXXXXXXX.....................XXXXXXXXXXXXX
XXXXXXXXX...........................XXXXXXXXXXX..................XXXXXXXXXXXXXXX
XXXXXXXXX...........................XXXXXXXX.......................XXXXXXXXXXXXX
XXXXXXXXXXX............................XX..............................XXXXXXXXX
XXXXXXXXXX............................................................XXXXXXXXXX
XXXXXXXXX..............................................................XXXXXXXXX
XXXXXXXXXX.............................................................XXXXXXXXX
XXXXXXXXX.............................................................XXXXXXXXXX
XXXXXXXXXX..............................................................XXXXXXXX
XXXXXXXXX.............................................................XXXXXXXXXX
XXXXXXXXXX...........................................................XXXXXXXXXXX
XXXXXXXXX...............................................................XXXXXXXX
XXXXXXXXXX........................................MMMMMMMMMMMMMMM......XXXXXXXXX
XXXXXXXXX...................................MMMMMMMMMMMMMMMMMMM.....XXXXXXXXXXXX
XXXXXXXXXXX......................................MMMMMMMMMMMMMMM.......XXXXXXXXX
XXXXXXXXXXXXXXX.......................................................XXXXXXXXXX
XXXXXXXXXXXXXXXMMMMMMMM............................................XXXXXXXXXXXXX
XXXXXXXXXXXXXXXXXXXMMMMMMMMMM........................................XXXXXXXXXXX
XXXXXXXXXXXXXXXXXXXXMMMMMMMMMMMMMMMMMMMMMM............................XXXXXXXXXX
XXXXXXXXXXXXXXXXXXXMMMMMMMMMMMMMMMMMMM.................................XXXXXXXXX
XXXXXXXXXXXXXXXXXXMMMMMMMMM...........................................XXXXXXXXXX
XXXXXXXXXXXXXXXXXX..................................................XXXXXXXXXXXX
XXXXXXXXXXXXXXXX......................................................XXXXXXXXXX
XXXXXXXXXXXXX........................................................XXXXXXXXXXX
XXXXXXXXXXXX........................................................XXXXXXXXXXXX
XXXXXXXXXXXXXX.....................................................XXXXXXXXXXXXX
XXXXXXXXXXXXXXXX..................................................XXXXXXXXXXXXXX
XXXXXXXXXXXXXXXXXX...............................XXXXX.........XXXXXXXXXXXXXXXXX
XXXXXXXXXXXXXXXXXXXXXXXXXXX....................XXXXXXXXX..XXXXXXXXXXXXXXXXXXXXXX
XXXXXXXXXXXXXXXXXXXXXXXXXXXXXXXXXXXXX...........XXXXXXXXXXXXXXXXXXXXXXXXXXXXXXXX
XXXXXXXXXXXXXXXXXXXXXXXXXXXXXXXXXXXXXXXXXXXXXXXXXXXXXXXXXXXXXXXXXXXXXXXXXXXXXXXX
XXXXXXXXXXXXXXXXXXXXXXXXXXXXXXXXXXXXXXXXXXXXXXXXXXXXXXXXXXXXXXXXXXXXXXXXXXXXXXXX