XXXXXXXXXXXXXXXXXXXXXXXXXXXXXXXXXXXXXXXXXXXXXXXXXXXXXXXXXXXXXXXXXXXXXXXXXXXXXXXX
XXXXXXXXXXXXXXXXXXXXXXXX...................XXXXXXXXXXXXXXXXXXXXXXXXXXXXXXXXXXXXX
XXXXXXXXXXXXXXXXXXXX...............................XXXXXXXXXXXXXXXXXXXXXXXXXXXXX
XXXXXXXXXXXXX...............................................XXXXXXXXXXXXXXXXXXXX
XXXXXXXXXXX.......................................................XXXXXXXXXXXXXX
XXXXXXXXXXX......................................................XXXXXXXXXXXXXXX
XXXXXXXXX..........................................................XXXXXXXXXXXXX
XXXXXXXXXX.........................................................XXXXXXXXXXXXX
XXXXXXXXX........................................................XXXXXXXXXXXXXXX
XXXXXXXXX..........................................................XXXXXXXXXXXXX
XXXXXXXXXXX............................................................XXXXXXXXX
XXXXXXXXXX............................................................XXXXXXXXXX
XXXXXXXXX..............................................................XXXXXXXXX
XXXXXXXXXX.............................................................XXXXXXXXX
XXXXXXXXX.........................XXXXXX..............................XXXXXXXXXX
XXXXXXXXXX.......................XXXXXXXXX..............................XXXXXXXX
XXXXXXXXX......................XXXXXXXXXXXXX..........................XXXXXXXXXX
XXXXXXXXXX......................XXXXXXXXXXX..........................XXXXXXXXXXX
XXXXXXXXX.........................XXXX..................................XXXXXXXX
XXXXXXXXXX.............................................................XXXXXXXXX
XXXXXXXXX...........................................................XXXXXXXXXXXX
XXXXXXXXXXX............................................................XXXXXXXXX
XXXXXXXXXXXXXXX.......................................................XXXXXXXXXX
XXXXXXXXXXXXXXXXXXXXX..............................................XXXXXXXXXXXXX
XXXXXXXXXXXXXXXXXXXXXXXXXXX..........................................XXXXXXXXXXX
XXXXXXXXXXXXXXXXXXXXXXXXXXXXXXXXXX....................................XXXXXXXXXX
XXXXXXXXXXXXXXXXXXXXXXXXXXXXXXXXXXX....................................XXXXXXXXX
XXXXXXXXXXXXXXXXXXXXXXXXXXXXXXXXXX....................................XXXXXXXXXX
XXXXXXXXXXXXXXXXXXXXXXXXXXXXXXX.....................................XXXXXXXXXXXX
XXXXXXXXXXXXXXXXXXXXXX................................................XXXXXXXXXX
XXXXXXXXXXXXX........................................................XXXXXXXXXXX
XXXXXXXXXXXX........................................................XXXXXXXXXXXX
XXXXXXXXXXXXXX.....................................................XXXXXXXXXXXXX
XXXXXXXXXXXXXXXX..................................................XXXXXXXXXXXXXX
XXXXXXXXXXXXXXXXXX.............................................XXXXXXXXXXXXXXXXX
XXXXXXXXXXXXXXXXXXXXXXXXXXX...............................XXXXXXXXXXXXXXXXXXXXXX
XXXXXXXXXXXXXXXXXXXXXXXXXXXXXXXXXXXXX..............XXXXXXXXXXXXXXXXXXXXXXXXXXXXX
XXXXXXXXXXXXXXXXXXXXXXXXXXXXXXXXXXXXXXXXXXXXXXXXXXXXXXXXXXXXXXXXXXXXXXXXXXXXXXXX
XXXXXXXXXXXXXXXXXXXXXXXXXXXXXXXXXXXXXXXXXXXXXXXXXXXXXXXXXXXXXXXXXXXXXXXXXXXXXXXX